//MAP CONVERTED BY dmm2tgm.py THIS HEADER COMMENT PREVENTS RECONVERSION, DO NOT REMOVE
"a" = (
/obj/structure/window/plasma/spawner/north,
/turf/open/lava/plasma/ice_moon,
/area/shuttle)
"b" = (
/obj/effect/fun_balloon/sentience/emergency_shuttle{
	group_name = "the zetan bouncer"
	},
/turf/open/floor/plating/abductor,
/area/shuttle)
"c" = (
/obj/item/kirbyplants/photosynthetic,
/obj/machinery/light/directional/north,
/turf/open/floor/plating/abductor,
/area/shuttle)
"d" = (
/mob/living/carbon/human/species/abductor/bouncer,
/turf/open/floor/plating/abductor,
/area/shuttle)
"e" = (
/obj/machinery/abductor/console{
	name = "abductor tv"
	},
/obj/machinery/light/directional/east,
/turf/open/floor/plating/abductor,
/area/shuttle)
"f" = (
/obj/effect/spawner/structure/window/reinforced/plasma/plastitanium,
/turf/open/floor/plating/abductor,
/area/shuttle)
"g" = (
/obj/structure/table/abductor,
/obj/machinery/recharger,
/obj/item/gun/energy/alien,
/turf/open/floor/plating/abductor,
/area/shuttle)
"h" = (
/obj/machinery/computer/terminal{
	dir = 1;
	name = "Left Arm Controls";
	upperinfo = "STRONG ALIENS USE ONLY";
	content = list("LEFT ARM OF THE FORBIDDEN ONE WILL CHOP AND PUNCH.")
	},
/obj/machinery/light/directional/south,
/turf/open/floor/plating/abductor,
/area/shuttle)
"i" = (
/obj/machinery/computer/terminal{
	dir = 1;
	name = "Right Arm Controlsl";
	upperinfo = "STRONG ALIENS USE ONLY";
	content = list("RIGHT ARM OF THE FORBBIDEN ONE WILL PICK UP SHIPS AND THROW THEM.")
	},
/obj/machinery/light/directional/south,
/turf/open/floor/plating/abductor,
/area/shuttle)
"j" = (
/obj/structure/chair/comfy/shuttle,
/turf/open/floor/plating/abductor,
/area/shuttle)
"k" = (
/obj/structure/table/abductor,
/obj/item/scalpel/alien,
/obj/item/cautery/alien,
/obj/item/retractor/alien,
/obj/item/hemostat/alien,
/obj/item/circular_saw/alien,
/obj/item/surgicaldrill/alien,
/turf/open/floor/plating/abductor,
/area/shuttle)
"m" = (
/obj/structure/chair/comfy/shuttle{
	dir = 4
	},
/turf/open/floor/plating/abductor,
/area/shuttle)
"n" = (
/obj/structure/table/abductor,
/obj/item/surgical_drapes,
/obj/item/surgical_drapes,
/obj/item/surgical_drapes,
/turf/open/floor/plating/abductor,
/area/shuttle)
"o" = (
/obj/structure/reagent_dispensers/fueltank,
/turf/open/floor/plating/abductor2,
/area/shuttle)
"p" = (
/obj/structure/chair/comfy/shuttle{
	dir = 8
	},
/turf/open/floor/plating/abductor,
/area/shuttle)
"q" = (
/turf/template_noop,
/area/template_noop)
"r" = (
/obj/machinery/light/directional/north,
/turf/open/floor/plating/abductor2,
/area/shuttle)
"s" = (
/obj/structure/table/abductor,
/obj/item/food/soylentgreen,
/turf/open/floor/plating/abductor,
/area/shuttle)
"t" = (
/obj/structure/closet/abductor,
/obj/item/abductor/gizmo,
/obj/item/abductor/gizmo,
/turf/open/floor/plating/abductor,
/area/shuttle)
"u" = (
/obj/structure/table/abductor,
/obj/machinery/recharger,
/obj/item/melee/baton/abductor{
	desc = "Even aliens can see the use of a good old-fashioned beating stick."
	},
/turf/open/floor/plating/abductor,
/area/shuttle)
"v" = (
/obj/structure/closet/abductor,
/obj/item/abductor/mind_device,
/obj/item/abductor/mind_device,
/turf/open/floor/plating/abductor,
/area/shuttle)
"w" = (
/obj/machinery/iv_drip,
/obj/structure/bed/abductor,
/obj/machinery/light/directional/east,
/turf/open/floor/plating/abductor,
/area/shuttle)
"x" = (
/turf/open/lava/plasma/ice_moon,
/area/shuttle)
"y" = (
/obj/machinery/abductor/console{
	name = "abductor tv"
	},
/obj/machinery/light/directional/west,
/turf/open/floor/plating/abductor,
/area/shuttle)
"z" = (
/obj/machinery/abductor/gland_dispenser{
	desc = "A tank filled with grotesque bits of flesh."
	},
/obj/machinery/light/directional/west,
/turf/open/floor/plating/abductor,
/area/shuttle)
"A" = (
/obj/machinery/harvester,
/turf/open/floor/plating/abductor,
/area/shuttle)
"B" = (
/obj/machinery/light/directional/north,
/turf/open/floor/plating/abductor,
/area/shuttle)
"D" = (
/obj/structure/closet/abductor,
/obj/item/abductor/silencer,
/obj/item/abductor/silencer,
/turf/open/floor/plating/abductor,
/area/shuttle)
"E" = (
/obj/effect/spawner/structure/window/reinforced/plasma/plastitanium,
/turf/closed/wall/mineral/abductor,
/area/shuttle)
"F" = (
/obj/structure/table/abductor,
/obj/item/organ/internal/heart/gland/egg,
/obj/item/organ/internal/heart/gland/heal,
/obj/item/organ/internal/heart/gland/access,
/obj/item/organ/internal/heart/gland/spiderman,
/turf/open/floor/plating/abductor,
/area/shuttle)
"G" = (
/obj/machinery/light/directional/west,
/turf/open/floor/plating/abductor,
/area/shuttle)
"I" = (
/obj/effect/spawner/structure/window/reinforced/plasma,
/turf/open/floor/plating/abductor2,
/area/shuttle)
"J" = (
/obj/machinery/abductor/console{
	name = "abductor tv"
	},
/turf/open/floor/plating/abductor,
/area/shuttle)
"K" = (
/obj/machinery/door/airlock/abductor,
/turf/open/floor/plating/abductor,
/area/shuttle)
"L" = (
/turf/open/floor/plating/abductor,
/area/shuttle)
"M" = (
/obj/structure/chair/comfy/shuttle{
	dir = 1
	},
/turf/open/floor/plating/abductor,
/area/shuttle)
"N" = (
/obj/machinery/computer/emergency_shuttle,
/turf/open/floor/plating/abductor,
/area/shuttle)
"O" = (
/obj/structure/table/optable/abductor,
/turf/open/floor/plating/abductor,
/area/shuttle)
"P" = (
/obj/structure/closet/abductor,
/obj/item/weldingtool/abductor{
	pixel_y = 3
	},
/obj/item/crowbar/abductor{
	pixel_x = -13
	},
/obj/item/wirecutters/abductor{
	pixel_y = 13
	},
/obj/item/multitool/abductor,
/turf/open/floor/plating/abductor,
/area/shuttle)
"Q" = (
/obj/machinery/abductor/console,
/turf/open/floor/plating/abductor,
/area/shuttle)
"R" = (
/turf/open/floor/plating/abductor2,
/area/shuttle)
"S" = (
/turf/closed/wall/mineral/abductor,
/area/shuttle)
"T" = (
/obj/machinery/abductor/gland_dispenser{
	desc = "A tank filled with grotesque bits of flesh."
	},
/turf/open/floor/plating/abductor,
/area/shuttle)
"U" = (
/obj/machinery/recharge_station,
/turf/open/floor/plating/abductor2,
/area/shuttle)
"V" = (
/obj/item/kirbyplants/photosynthetic,
/turf/open/floor/plating/abductor,
/area/shuttle)
"W" = (
/obj/machinery/light/directional/east,
/turf/open/floor/plating/abductor,
/area/shuttle)
"X" = (
/obj/machinery/light/directional/south,
/turf/open/floor/plating/abductor,
/area/shuttle)
"Y" = (
/obj/machinery/door/airlock/abductor,
/obj/docking_port/mobile/emergency{
	name = "Zetan battle cruiser"
	},
/turf/open/floor/plating/abductor,
/area/shuttle)

(1,1,1) = {"
q
q
q
q
q
q
q
S
S
K
E
Y
S
S
S
S
S
K
E
K
S
S
q
q
q
q
"}
(2,1,1) = {"
q
q
q
q
q
q
q
S
J
L
G
L
L
L
G
m
m
L
y
L
s
S
S
q
q
q
"}
(3,1,1) = {"
q
q
q
q
q
q
q
S
B
L
L
L
L
L
L
L
L
L
L
L
j
i
S
q
q
q
"}
(4,1,1) = {"
q
q
q
q
q
q
q
S
p
L
p
p
p
p
s
S
S
S
S
S
S
S
S
q
q
I
"}
(5,1,1) = {"
q
q
q
q
q
q
q
S
f
K
f
f
f
f
V
S
S
S
S
S
S
S
S
S
I
I
"}
(6,1,1) = {"
S
S
S
S
S
q
q
S
m
L
L
L
L
L
f
O
T
O
z
f
U
o
o
S
I
I
"}
(7,1,1) = {"
S
Q
L
L
S
S
q
S
L
L
L
L
L
X
f
B
L
L
L
f
R
R
R
a
x
I
"}
(8,1,1) = {"
S
Q
R
L
X
S
q
S
B
L
R
R
L
M
f
t
L
L
k
f
R
R
R
a
x
I
"}
(9,1,1) = {"
S
c
L
L
L
u
S
S
L
R
R
R
R
M
f
D
L
L
n
f
r
R
R
a
x
I
"}
(10,1,1) = {"
S
N
M
L
L
b
L
d
R
R
R
R
R
R
K
L
L
L
L
K
R
S
S
S
I
q
"}
(11,1,1) = {"
S
c
L
L
L
g
S
S
L
R
R
R
R
M
f
v
L
L
F
f
r
R
R
a
x
I
"}
(12,1,1) = {"
S
Q
R
L
X
S
q
S
B
L
R
R
L
M
f
P
L
L
k
f
R
R
R
a
x
I
"}
(13,1,1) = {"
S
Q
L
L
S
S
q
S
L
L
L
L
L
X
f
B
L
L
L
f
R
R
R
a
x
I
"}
(14,1,1) = {"
S
S
S
S
S
q
q
S
p
L
L
L
L
L
f
A
L
L
w
f
U
o
o
S
I
I
"}
(15,1,1) = {"
q
q
q
q
q
q
q
S
f
K
f
f
f
f
V
S
S
S
S
S
S
S
S
S
I
I
"}
(16,1,1) = {"
q
q
q
q
q
q
q
S
m
L
m
m
m
m
s
S
S
S
S
S
S
S
S
q
q
I
"}
(17,1,1) = {"
q
q
q
q
q
q
q
S
B
L
L
L
L
L
L
L
L
L
L
L
j
h
S
q
q
q
"}
(18,1,1) = {"
q
q
q
q
q
q
q
S
J
L
W
L
L
L
L
p
p
p
e
L
s
S
S
q
q
q
"}
(19,1,1) = {"
q
q
q
q
q
q
q
S
S
K
E
S
K
S
S
S
S
K
E
K
S
S
q
q
q
q
"}
