//MAP CONVERTED BY dmm2tgm.py THIS HEADER COMMENT PREVENTS RECONVERSION, DO NOT REMOVE
"aJ" = (
/obj/machinery/computer/terminal{
	dir = 1;
	name = "Left Arm Controls";
	upperinfo = "STRONG ALIENS USE ONLY";
	content = list("LEFT ARM OF THE FORBIDDEN ONE WILL CHOP AND PUNCH.")
	},
/obj/machinery/light/directional/south,
/turf/open/floor/plating/abductor,
/area/shuttle/pirate/zetan)
"bI" = (
/obj/structure/closet/abductor,
/obj/item/restraints/handcuffs/alien,
/obj/item/restraints/handcuffs/alien,
/obj/item/restraints/handcuffs/alien,
/obj/item/restraints/handcuffs/alien,
/obj/item/restraints/handcuffs/alien,
/obj/item/stack/cable_coil/five,
/obj/item/stack/cable_coil/five,
/obj/item/stack/cable_coil/five,
/obj/item/stack/cable_coil/five,
/turf/open/floor/plating/abductor,
/area/shuttle/pirate/zetan)
"cZ" = (
/obj/structure/closet/abductor,
/obj/item/weldingtool/abductor{
	pixel_y = 3
	},
/obj/item/wirecutters/abductor{
	pixel_y = 13
	},
/obj/item/multitool/abductor,
/obj/item/crowbar/abductor,
/obj/item/screwdriver/abductor,
/obj/item/wrench/abductor,
/turf/open/floor/plating/abductor,
/area/shuttle/pirate/zetan)
"et" = (
/obj/machinery/computer/shuttle/pirate,
/turf/open/floor/plating/abductor,
/area/shuttle/pirate/zetan)
"eN" = (
/obj/structure/closet/abductor,
/obj/item/multitool/abductor,
/obj/item/weldingtool/abductor{
	pixel_y = 3
	},
/obj/item/crowbar/abductor,
/obj/item/screwdriver/abductor,
/obj/item/wrench/abductor,
/turf/open/floor/plating/abductor,
/area/shuttle/pirate/zetan)
"eO" = (
/obj/machinery/piratepad,
/turf/open/floor/plating/abductor,
/area/shuttle/pirate/zetan)
"ff" = (
/obj/machinery/shuttle_scrambler,
/turf/open/floor/plating/abductor,
/area/shuttle/pirate/zetan)
"iv" = (
/obj/structure/table/abductor,
/obj/item/surgical_drapes,
/obj/item/surgical_drapes,
/obj/item/surgical_drapes,
/turf/open/floor/plating/abductor,
/area/shuttle/pirate/zetan)
"iE" = (
/obj/machinery/zetan_pirate_experimentor{
	dir = 8
	},
/turf/open/floor/plating/abductor,
/area/shuttle/pirate/zetan)
"jG" = (
/obj/effect/spawner/structure/window/reinforced/plasma,
/turf/open/floor/plating/abductor2,
/area/shuttle/pirate/zetan)
"kx" = (
/obj/machinery/loot_locator,
/turf/open/floor/plating/abductor,
/area/shuttle/pirate/zetan)
"kJ" = (
/obj/structure/chair/comfy/shuttle{
	dir = 4
	},
/turf/open/floor/plating/abductor,
/area/shuttle/pirate/zetan)
"kW" = (
/obj/machinery/iv_drip,
/obj/structure/bed/abductor,
/obj/machinery/light/directional/east,
/turf/open/floor/plating/abductor,
/area/shuttle/pirate/zetan)
"mr" = (
/obj/machinery/door/airlock/abductor,
/turf/open/floor/plating/abductor,
/area/shuttle/pirate/zetan)
"mw" = (
/obj/structure/table/abductor,
/obj/item/organ/internal/heart/gland/egg,
/obj/item/organ/internal/heart/gland/heal,
/obj/item/organ/internal/heart/gland/access,
/obj/item/organ/internal/heart/gland/spiderman,
/turf/open/floor/plating/abductor,
/area/shuttle/pirate/zetan)
"nA" = (
/obj/structure/chair/comfy/shuttle,
/turf/open/floor/plating/abductor,
/area/shuttle/pirate/zetan)
"og" = (
/obj/item/kirbyplants/photosynthetic,
/obj/machinery/light/directional/north,
/turf/open/floor/plating/abductor,
/area/shuttle/pirate/zetan)
"pb" = (
/turf/open/floor/plating/abductor2,
/area/shuttle/pirate/zetan)
"pT" = (
/obj/structure/table/abductor,
/obj/machinery/recharger,
/turf/open/floor/plating/abductor,
/area/shuttle/pirate/zetan)
"ri" = (
/obj/machinery/computer/piratepad_control,
/turf/open/floor/plating/abductor,
/area/shuttle/pirate/zetan)
"sm" = (
/turf/open/floor/plating/abductor,
/area/shuttle/pirate/zetan)
"sW" = (
/obj/effect/mob_spawn/ghost_role/human/pirate/zetan,
/turf/open/floor/plating/abductor,
/area/shuttle/pirate/zetan)
"tm" = (
/obj/structure/table/abductor,
/obj/item/scalpel/alien,
/obj/item/cautery/alien,
/obj/item/retractor/alien,
/obj/item/hemostat/alien,
/obj/item/circular_saw/alien,
/obj/item/surgicaldrill/alien,
/turf/open/floor/plating/abductor,
/area/shuttle/pirate/zetan)
"tY" = (
/obj/machinery/door/airlock/abductor,
/obj/docking_port/mobile/pirate{
	dir = 8;
	name = "Zetan Battlecruiser";
	port_direction = 4;
	preferred_direction = 8
	},
/turf/open/floor/plating/abductor,
/area/shuttle/pirate/zetan)
"vY" = (
/obj/effect/spawner/structure/window/reinforced/plasma/plastitanium,
/turf/open/floor/plating/abductor,
/area/shuttle/pirate/zetan)
"wz" = (
/obj/machinery/abductor/console{
	name = "abductor tv"
	},
/obj/machinery/light/directional/west,
/turf/open/floor/plating/abductor,
/area/shuttle/pirate/zetan)
"xD" = (
/obj/machinery/light/directional/south,
/obj/machinery/computer/camera_advanced/shuttle_docker/syndicate/pirate{
	dir = 4;
	y_offset = -4;
	x_offset = -9
	},
/turf/open/floor/plating/abductor,
/area/shuttle/pirate/zetan)
"xN" = (
/obj/machinery/harvester,
/turf/open/floor/plating/abductor,
/area/shuttle/pirate/zetan)
"zj" = (
/obj/machinery/light/directional/north,
/turf/open/floor/plating/abductor,
/area/shuttle/pirate/zetan)
"Az" = (
/obj/machinery/zetan_pirate_experimentor{
	dir = 4
	},
/turf/open/floor/plating/abductor,
/area/shuttle/pirate/zetan)
"Dp" = (
/obj/structure/chair/comfy/shuttle{
	dir = 1
	},
/turf/open/floor/plating/abductor,
/area/shuttle/pirate/zetan)
"Ef" = (
/obj/machinery/abductor/gland_dispenser{
	desc = "A tank filled with grotesque bits of flesh."
	},
/obj/machinery/light/directional/west,
/turf/open/floor/plating/abductor,
/area/shuttle/pirate/zetan)
"FS" = (
/obj/structure/reagent_dispensers/fueltank,
/turf/open/floor/plating/abductor2,
/area/shuttle/pirate/zetan)
"FZ" = (
/obj/machinery/light/directional/west,
/turf/open/floor/plating/abductor,
/area/shuttle/pirate/zetan)
"GU" = (
/obj/machinery/abductor/console{
	name = "abductor tv"
	},
/obj/machinery/light/directional/east,
/turf/open/floor/plating/abductor,
/area/shuttle/pirate/zetan)
"Ig" = (
/obj/machinery/light/directional/south,
/turf/open/floor/plating/abductor,
/area/shuttle/pirate/zetan)
"Iv" = (
/obj/structure/closet/abductor,
/obj/item/abductor/silencer,
/obj/item/abductor/silencer,
/obj/item/bodybag/environmental,
/obj/item/bodybag/environmental,
/obj/item/bodybag/environmental,
/obj/item/bodybag/environmental,
/obj/item/bodybag/environmental,
/turf/open/floor/plating/abductor,
/area/shuttle/pirate/zetan)
"IV" = (
/obj/structure/table/abductor,
/obj/item/food/soylentgreen,
/turf/open/floor/plating/abductor,
/area/shuttle/pirate/zetan)
"Je" = (
/turf/closed/wall/mineral/abductor,
/area/shuttle/pirate/zetan)
"Js" = (
/turf/open/lava/plasma/ice_moon,
/area/shuttle/pirate/zetan)
"KH" = (
/obj/effect/spawner/structure/window/reinforced/plasma/plastitanium,
/turf/closed/wall/mineral/abductor,
/area/shuttle/pirate/zetan)
"Le" = (
/obj/machinery/light/directional/east,
/turf/open/floor/plating/abductor,
/area/shuttle/pirate/zetan)
"Ng" = (
/obj/machinery/recharge_station,
/turf/open/floor/plating/abductor2,
/area/shuttle/pirate/zetan)
"Nv" = (
/obj/structure/window/plasma/spawner/north,
/turf/open/lava/plasma/ice_moon,
/area/shuttle/pirate/zetan)
"Pk" = (
/obj/item/kirbyplants/photosynthetic,
/turf/open/floor/plating/abductor,
/area/shuttle/pirate/zetan)
"PB" = (
/turf/template_noop,
/area/template_noop)
"Rv" = (
/obj/structure/table/optable/abductor,
/turf/open/floor/plating/abductor,
/area/shuttle/pirate/zetan)
"SI" = (
/obj/machinery/abductor/console{
	name = "abductor tv"
	},
/turf/open/floor/plating/abductor,
/area/shuttle/pirate/zetan)
"TU" = (
/obj/machinery/light/directional/south,
/obj/effect/mob_spawn/ghost_role/human/pirate/zetan/captain,
/turf/open/floor/plating/abductor,
/area/shuttle/pirate/zetan)
"TX" = (
/obj/structure/table/abductor,
/obj/item/food/soylentgreen,
/obj/item/toy/plush/abductor/agent,
/turf/open/floor/plating/abductor,
/area/shuttle/pirate/zetan)
"Xb" = (
/obj/structure/chair/comfy/shuttle{
	dir = 8
	},
/turf/open/floor/plating/abductor,
/area/shuttle/pirate/zetan)
"Yc" = (
/obj/machinery/computer/terminal{
	dir = 1;
	name = "Right Arm Controlsl";
	upperinfo = "STRONG ALIENS USE ONLY";
	content = list("RIGHT ARM OF THE FORBBIDEN ONE WILL PICK UP SHIPS AND THROW THEM.")
	},
/obj/machinery/light/directional/south,
/turf/open/floor/plating/abductor,
/area/shuttle/pirate/zetan)
"YB" = (
/obj/machinery/abductor/console,
/turf/open/floor/plating/abductor,
/area/shuttle/pirate/zetan)
"YX" = (
/obj/structure/table/abductor,
/obj/item/food/soylentgreen,
/obj/item/toy/plush/abductor,
/turf/open/floor/plating/abductor,
/area/shuttle/pirate/zetan)
"Zs" = (
/obj/machinery/light/directional/north,
/turf/open/floor/plating/abductor2,
/area/shuttle/pirate/zetan)

(1,1,1) = {"
PB
PB
PB
PB
PB
PB
PB
Je
Je
mr
KH
mr
Je
Je
Je
Je
Je
mr
KH
mr
Je
Je
PB
PB
PB
PB
"}
(2,1,1) = {"
PB
PB
PB
PB
PB
PB
PB
Je
SI
sm
FZ
sm
sm
sm
FZ
kJ
kJ
sm
wz
sm
IV
Je
Je
PB
PB
PB
"}
(3,1,1) = {"
PB
PB
PB
PB
PB
PB
PB
Je
zj
sm
sm
sm
sm
sm
sm
sm
sm
sm
sm
sm
nA
Yc
Je
PB
PB
PB
"}
(4,1,1) = {"
PB
PB
PB
PB
PB
PB
PB
Je
Xb
sm
Xb
Xb
Xb
Xb
YX
Je
Je
Je
Je
Je
Je
Je
Je
PB
PB
jG
"}
(5,1,1) = {"
PB
PB
PB
PB
PB
PB
PB
Je
vY
mr
vY
vY
vY
vY
Pk
Je
Je
Je
Je
Je
Je
Je
Je
Je
jG
jG
"}
(6,1,1) = {"
Je
Je
Je
Je
Je
PB
PB
Je
kJ
sm
Az
sm
sm
sW
vY
ri
eO
Rv
Ef
vY
Ng
FS
FS
Je
jG
jG
"}
(7,1,1) = {"
Je
YB
sm
ff
Je
Je
PB
Je
sm
sm
sm
sm
sm
Ig
vY
zj
sm
sm
sm
vY
pb
pb
pb
Nv
Js
jG
"}
(8,1,1) = {"
Je
YB
pb
sm
xD
Je
PB
Je
zj
sm
pb
pb
sm
Dp
vY
bI
sm
sm
tm
vY
pb
pb
pb
Nv
Js
jG
"}
(9,1,1) = {"
Je
og
sm
sm
sm
kx
Je
Je
sm
pb
pb
pb
pb
Dp
vY
Iv
sm
sm
iv
vY
Zs
pb
pb
Nv
Js
jG
"}
(10,1,1) = {"
Je
et
Dp
sm
sm
sm
mr
sm
pb
pb
pb
pb
pb
pb
mr
sm
sm
sm
sm
mr
pb
Je
Je
Je
jG
PB
"}
(11,1,1) = {"
Je
og
sm
sm
sm
pT
Je
Je
sm
pb
pb
pb
pb
Dp
vY
eN
sm
sm
mw
vY
Zs
pb
pb
Nv
Js
jG
"}
(12,1,1) = {"
Je
YB
pb
sm
TU
Je
PB
Je
zj
sm
pb
pb
sm
Dp
vY
cZ
sm
sm
tm
vY
pb
pb
pb
Nv
Js
jG
"}
(13,1,1) = {"
Je
YB
sm
sm
Je
Je
PB
Je
sm
sm
sm
sm
sm
Ig
vY
zj
sm
sm
sm
vY
pb
pb
pb
Nv
Js
jG
"}
(14,1,1) = {"
Je
Je
Je
Je
Je
PB
PB
Je
Xb
sm
iE
sm
sm
sW
vY
xN
sm
sm
kW
vY
Ng
FS
FS
Je
jG
jG
"}
(15,1,1) = {"
PB
PB
PB
PB
PB
PB
PB
Je
vY
mr
vY
vY
vY
vY
Pk
Je
Je
Je
Je
Je
Je
Je
Je
Je
jG
jG
"}
(16,1,1) = {"
PB
PB
PB
PB
PB
PB
PB
Je
kJ
sm
kJ
kJ
kJ
kJ
TX
Je
Je
Je
Je
Je
Je
Je
Je
PB
PB
jG
"}
(17,1,1) = {"
PB
PB
PB
PB
PB
PB
PB
Je
zj
sm
sm
sm
sm
sm
sm
sm
sm
sm
sm
sm
nA
aJ
Je
PB
PB
PB
"}
(18,1,1) = {"
PB
PB
PB
PB
PB
PB
PB
Je
SI
sm
Le
sm
sm
sm
sm
Xb
Xb
Xb
GU
sm
IV
Je
Je
PB
PB
PB
"}
(19,1,1) = {"
PB
PB
PB
PB
PB
PB
PB
Je
Je
tY
KH
Je
mr
Je
Je
Je
Je
mr
KH
mr
Je
Je
PB
PB
PB
PB
"}
